1111111111111111111111111111111111111111111111111111111111111111
1111111111111111111111111111111111111111111111111111111111111111
1111111111111111111111111111111111111111111111111111111111111111
1111111100000000000000000000000110000000000000000000000011111111
1111111100000000000000000000000110000000000000000000000011111111
1111111100111110011111111111100110011111111111100111110011111111
1111111100111110011111111111100110011111111111100111110011111111
1111111100000000000000000000000000000000000000000000000011111111
1111111100000000000000000000000000000000000000000000000011111111
1111111100111110011001111111111111111111111001100111110011111111
1111111100000000011000000000000110000000000001100000000011111111
1111111100000000011000000000000110000000000001100000000011111111
1111111111111110011111111111100110011111111111100111111111111111
1111111111111110011000000000000000000000000001100111111111111111
1111111111111110011000000000000000000000000001100111111111111111
1111111111111110011001111111111111111111111001100111111111111111
1111111111111110011001100000000000000000011001100111111111111111
0000000000000000000001100000000000000000011000000000000000000000
0000000000000000000001100000000000000000011000000000000000000000
1111111111111110011001100000000000000000011001100111111111111111
1111111111111110011001111111111111111111111001100111111111111111
1111111111111110011000000000000000000000000001100111111111111111
1111111111111110011000000000000000000000000001100111111111111111
1111111111111110011001111111111111111111111001100111111111111111
1111111100000000000000000000000110000000000000000000000011111111
1111111100000000000000000000000110000000000000000000000011111111
1111111100111110011111111111100110011111111111100111110011111111
1111111100000010000000000000000000000000000000000100000011111111
1111111100000010000000000000000000000000000000000100000011111111
1111111111110010011001111111111111111111111001100100111111111111
1111111100000000011000000000000110000000000001100000000011111111
1111111100000000011000000000000110000000000001100000000011111111
1111111100111111111111111111100110011111111111111111110011111111
1111111100000000000000000000000000000000000000000000000011111111
1111111100000000000000000000000000000000000000000000000011111111
1111111111111111111111111111111111111111111111111111111111111111
1111111111111111111111111111111111111111111111111111111111111111
1111111111111111111111111111111111111111111111111111111111111111
1111111110000111111011111100011111011101111111011110111011111111
1111111110111011110101111011111111001001111110101110011011111111
1111111110111011110101110111111110101010111110101110011011111111
1111111110111011101110110111111110110110111101110110101011111111
1111111110000111101110110111111110111110111101110110101011111111
1111111110111111100000110111111101111111011100000110110011111111
1111111110111111011111011011111101111111011011111010110011111111
1111111110111111011111011100011101111111011011111010111011111111
1111111111111111111111111111111111111111111111111111111111111111
1111111111111111111111111111111111111111111111111111111111111111
